intervention,"Active, not recruiting",Completed,Enrolling by invitation,Recruiting,Terminated,Total
placebo,28,16,13,261,5,323
hydroxychloroquine,18,14,6,66,9,113
standard care,8,14,8,77,2,109
convalescent plasma,7,14,4,69,0,94
azithromycin,6,2,2,25,2,37
tocilizumab,4,5,0,21,2,32
mesenchymal stem cells,4,3,3,20,0,30
saline,1,0,3,24,0,28
ritonavir,1,6,2,17,1,27
lopinavir,1,4,2,17,1,25
ivermectin,2,4,1,17,0,24
favipiravir,4,3,1,15,0,23
lopinavir/ritonavir,1,4,2,14,1,22
blood sample,0,1,0,18,0,19
remdesivir,1,5,0,12,1,19
chloroquine,0,2,0,15,1,18
enoxaparin,0,0,0,16,0,16
heparin,2,0,1,12,0,15
oxygen,2,0,0,13,0,15
prone positioning,0,0,2,13,0,15
colchicine,0,0,0,14,0,14
control,1,2,0,11,0,14
methylprednisolone,2,3,0,9,0,14
plasma,0,3,1,10,0,14
interferon,0,4,1,8,0,13
vitamin c,4,1,1,7,0,13
nitazoxanide,1,1,0,10,0,12
dexamethasone,0,1,0,9,1,11
exercise,1,2,0,8,0,11
hydroxychloroquine / azithromycin,1,4,2,3,1,11
questionnaire,0,1,1,8,0,10
vitamin d,2,0,0,8,0,10
anakinra,1,0,0,8,0,9
bcg,2,0,0,7,0,9
serology test,0,0,0,9,0,9
nitric oxide,2,0,0,6,0,8
ruxolitinib,1,0,0,7,0,8
zinc,0,1,1,6,0,8
baricitinib,1,1,0,5,0,7
losartan,0,1,0,6,0,7
povidone/iodine,0,2,0,5,0,7
radiotherapy,1,0,0,6,0,7
telehealth,0,0,0,7,0,7
best available therapy,0,0,0,6,0,6
biological samples,0,0,0,6,0,6
oseltamivir,1,0,0,5,0,6
sarilumab,1,2,0,3,0,6
cholecalciferol,0,0,0,5,0,5
clazakizumab,1,0,0,4,0,5
inactivated sars-cov-2 vaccine,1,0,1,3,0,5
ly3819253,0,1,0,4,0,5
pcr,0,0,0,5,0,5
rivaroxaban,0,0,0,5,0,5
saliva,1,0,0,4,0,5
sofosbuvir,0,1,0,4,0,5
telmisartan,0,0,0,5,0,5
therapeutic plasma exchange (tpe),1,2,1,1,0,5
anticoagulation,0,0,0,4,0,4
arbidol,1,1,0,2,0,4
blood test,0,0,0,4,0,4
bromhexine hydrochloride,1,1,1,1,0,4
budesonide,0,0,0,4,0,4
camostat mesilate,0,0,0,4,0,4
chloroquine/hydroxychloroquine,0,0,0,4,0,4
doxycycline,0,1,1,2,0,4
low,1,0,0,3,0,4
mavrilimumab,0,0,0,4,0,4
na-831,0,0,2,2,0,4
nasopharyngeal swab,0,0,0,4,0,4
nk cells,0,0,0,4,0,4
peginterferon,1,0,1,2,0,4
regn10933,0,0,0,4,0,4
regn10987,0,0,0,4,0,4
supportive care,1,1,0,2,0,4
,1,1,1,0,0,3
ad26.cov2.s,0,0,0,3,0,3
adenovirus type 5 vector,2,0,0,1,0,3
aspirin,0,0,1,2,0,3
best supportive care,0,1,0,2,0,3
biological,0,0,0,3,0,3
blood,0,0,0,3,0,3
blood donation sms,0,1,2,0,0,3
bnt162b1,0,0,0,3,0,3
chadox1,1,0,0,2,0,3
ciclesonide,0,0,0,3,0,3
clopidogrel,0,1,0,2,0,3
corticosteroid,0,0,0,3,0,3
daclatasvir,0,0,0,3,0,3
gam-covid-vac,0,1,0,2,0,3
imatinib,0,0,0,3,0,3
immunoglobulin,0,0,0,3,0,3
information,0,0,2,1,0,3
lenzilumab,1,0,0,2,0,3
melatonin,1,0,0,2,0,3
mindfulness,0,0,0,3,0,3
mrna-1273,2,0,0,1,0,3
nigella sativa,0,0,0,3,0,3
prednisone,0,1,0,2,0,3
probiotic,0,0,0,3,0,3
pulmozyme,0,0,0,3,0,3
rapid test,0,0,1,2,0,3
ribavirin,0,1,0,2,0,3
sargramostim,0,0,0,3,0,3
sevoflurane,0,0,0,3,0,3
sirolimus,0,0,0,3,0,3
soc,0,0,0,3,0,3
sodium,0,0,0,3,0,3
survey,0,0,0,3,0,3
vitamin super b-complex,0,0,0,3,0,3
vpm1002,1,0,0,2,0,3
28-day schedule,0,0,1,1,0,2
acalabrutinib,1,0,0,1,0,2
ace inhibitor,0,0,1,1,0,2
acetylsalicylic acid,0,1,0,1,0,2
adjuvant,0,0,0,2,0,2
aeonose,0,2,0,0,0,2
antibiotics,0,1,0,1,0,2
arb,0,0,0,2,0,2
atorvastatin,0,0,0,2,0,2
ayurveda,0,2,0,0,0,2
bacille calmette-guã©rin (bcg),0,0,0,2,0,2
behavior,0,0,0,2,0,2
behavioral,0,0,1,1,0,2
bevacizumab,0,1,0,1,0,2
bnt162b2,0,0,0,2,0,2
canakinumab,1,0,0,1,0,2
cannabidiol,0,0,0,2,0,2
cellectraâ® 2000,1,0,0,1,0,2
cenicriviroc,0,0,0,2,0,2
conjunctival swab,0,1,0,1,0,2
"conventional medicines (oxygen therapy, alfa interferon via aerosol inhalation,/lopinavir/ritonavir)/traditional chinese medicines (tcms) granules",0,0,0,2,0,2
coviage,0,2,0,0,0,2
cpap,0,0,0,2,0,2
ct-scan,0,0,0,2,0,2
cumin,0,0,0,2,0,2
cyclosporine,0,0,0,2,0,2
cytokine adsorption,0,0,0,2,0,2
cytosorb,0,0,0,2,0,2
dapagliflozin,0,0,0,2,0,2
data collection,0,1,0,1,0,2
dipyridamole,0,0,0,2,0,2
edp1815,0,0,0,2,0,2
education,0,0,1,1,0,2
eidd-2801,0,0,0,2,0,2
emtricitabine,0,0,0,2,0,2
famotidine,0,0,0,2,0,2
favipiravir placebo,0,0,0,2,0,2
favipiravir/hydroxychloroquine,0,0,0,2,0,2
honey,0,0,0,2,0,2
hormones,1,0,0,1,0,2
hyperbaric oxygen,0,0,0,1,1,2
ibrutinib,0,0,0,2,0,2
ibuprofen,0,0,0,2,0,2
igg,0,0,0,2,0,2
igm antibodytest,0,0,0,2,0,2
iloprost,0,0,0,2,0,2
imu-838,0,0,0,2,0,2
ino-4800,1,0,0,1,0,2
interleukin,0,0,0,2,0,2
iodine,0,0,0,2,0,2
kb109,0,0,0,2,0,2
kb109 / self supportive care (ssc),0,0,0,2,0,2
kg,0,0,0,2,0,2
lanadelumab,0,0,0,2,0,2
ledipasvir,0,1,0,1,0,2
lung ultrasound,0,0,0,2,0,2
"magpro x100 stimulator, b70 fluid-cooled coil",0,0,0,2,0,2
maraviroc,0,0,0,2,0,2
mechanical ventilation,0,0,0,2,0,2
meditation,0,0,1,1,0,2
medium dosage inactivated sars-cov-2 vaccine on a 0-,0,0,1,1,0,2
medium dosage inactivated sars-cov-2 vaccine on a 0-/28-day schedule,0,0,1,1,0,2
mefloquine,2,0,0,0,0,2
n-acetylcysteine,0,0,0,2,0,2
nafamostat mesilate,0,0,0,2,0,2
nasal rinse,0,0,0,2,0,2
nigella sativa / black cumin,0,0,0,2,0,2
octagam,0,0,0,2,0,2
omega-3,0,0,0,2,0,2
online support group,1,0,0,1,0,2
opaganib,0,0,0,2,0,2
ophthalmologic exam,0,0,0,2,0,2
oral polio vaccine,0,0,2,0,0,2
phone call,0,0,0,2,0,2
physical therapy,1,0,0,1,0,2
povidone-iodine,0,0,0,2,0,2
preventive information,0,0,2,0,0,2
pul-042,0,0,0,2,0,2
pyronaridine-artesunate,0,0,0,2,0,2
quercetin,0,0,0,2,0,2
ravulizumab,0,0,0,2,0,2
recombinant new coronavirus vaccine (cho cell) low-dose group,0,0,0,2,0,2
recombinant new coronavirus vaccine (cho cells) high-dose group,0,0,0,2,0,2
regn10933 / regn10987,0,0,0,2,0,2
regn10933/regn10987 combination therapy,0,0,0,2,0,2
sars-cov-2 rs,0,0,0,2,0,2
sars-cov-2 rs/matrix-m1 adjuvant,0,0,0,2,0,2
self supportive care (ssc),0,0,0,2,0,2
self supportive care (ssc) alone,0,0,0,2,0,2
serum test,0,0,0,2,0,2
siltuximab,0,0,0,2,0,2
soc / placebo,0,0,0,2,0,2
sofosbuvir/ledipasvir,0,1,0,1,0,2
stool collection,0,0,0,2,0,2
td-0903,0,1,0,1,0,2
tele-yoga therapy,0,2,0,0,0,2
thromboprophylaxis,0,0,0,2,0,2
tofacitinib,0,0,0,2,0,2
water,0,1,0,1,0,2
yoga,0,0,0,2,0,2
- tocilizumab,1,0,0,0,0,1
-interferon nebulization,0,1,0,0,0,1
"""calm"" is a mindfulness meditation mobile app",0,0,0,1,0,1
0.12% chg oral rinse,0,0,0,1,0,1
0.4ml inj syringe 0.4ml,0,0,0,1,0,1
0.67ml inj syringe,1,0,0,0,0,1
10 to 14 days later,0,0,0,1,0,1
100 mg,0,0,0,1,0,1
1200 mg),0,0,0,1,0,1
14-day schedule,0,0,0,1,0,1
1600 mg),0,0,0,1,0,1
18f-î±vî²6-bp,0,0,1,0,0,1
2.2x10^10vp (qpcr) boost,0,0,0,1,0,1
21 - phase 2,0,0,0,1,0,1
4plants,0,0,1,0,0,1
4plants/azythromycin,0,0,1,0,0,1
5x10^10vp boost (qpcr),0,0,0,1,0,1
6 months later,0,0,0,1,0,1
a short video intervention,0,0,0,1,0,1
a vignette intervention,0,0,0,1,0,1
aã§aã­ palm berry extract - natural product,0,0,0,1,0,1
aapc,0,0,0,1,0,1
aaz covid-19 rapid test,0,0,0,1,0,1
abx464,0,0,0,1,0,1
accuchek inform ii platform,0,0,0,1,0,1
"ace inhibitor, angiotensin receptor blocker",0,0,0,1,0,1
actigraphy,0,0,0,1,0,1
action (tara),0,1,0,0,0,1
activase,0,0,0,1,0,1
active comparator,0,0,0,1,0,1
ad5-ncov,0,0,0,1,0,1
adenovirus type-5 vectored covid-19 vaccine,1,0,0,0,0,1
adimrsc-2f,0,0,0,1,0,1
adsorbed covid-19 (inactivated) vaccine,0,0,0,1,0,1
aerosolized dnase,0,0,0,1,0,1
after-each-case room disinfection,0,1,0,0,0,1
ag0301-covid19,1,0,0,0,0,1
ag0302-covid19,1,0,0,0,0,1
albumine,0,0,0,1,0,1
allocetra-ots,0,0,0,1,0,1
allogeneic,0,0,0,1,0,1
almitrine,0,0,0,1,0,1
alpha one antitrypsin,0,0,0,1,0,1
alum adjuvant,0,0,0,1,0,1
aluminum adjuvant of inactivated sars-cov-2 vaccine,0,0,0,1,0,1
alveolar,0,0,0,1,0,1
ambrisentan,0,0,0,1,0,1
ambulation,0,0,0,1,0,1
amiodarone,0,0,0,1,0,1
ampion,1,0,0,0,0,1
anakinra/osoc,0,0,0,1,0,1
ang-3777,0,0,0,1,0,1
anger message,0,1,0,0,0,1
angiography scanner,0,0,0,1,0,1
angiotensin peptide (1-7) derived plasma,0,0,0,1,0,1
anise,0,0,0,1,0,1
anluohuaxian,0,0,0,1,0,1
anti-coronavirus antibodies (immunoglobulins)obtained with dfpp from convalescent patients,0,0,0,1,0,1
anti-sars-cov-2 igt seropositivity,0,1,0,0,0,1
anti-sars-cov-2 igy,0,0,0,1,0,1
antibody test,0,0,0,1,0,1
antihypertensives,0,0,0,1,0,1
antioxidants,0,0,0,1,0,1
anxiety,0,0,0,1,0,1
anxiety reduction training,0,0,0,1,0,1
apilimod dimesylate,0,0,0,1,0,1
apl-9,0,0,0,1,0,1
apps,0,0,0,1,0,1
apremilast,0,0,0,1,0,1
aprepitant injectable emulsion,0,0,0,1,0,1
aprotinin,1,0,0,0,0,1
arbidol hydrochloride/interferon atomization,0,0,0,1,0,1
ardsnet,0,0,0,1,0,1
argatroban,0,0,0,1,0,1
artemesia annua,0,0,0,1,0,1
artemic,0,0,0,1,0,1
artesunate-amodiaquine,0,0,0,1,0,1
asbrip,0,0,0,1,0,1
asc09,0,0,0,1,0,1
asc09f/oseltamivir,0,0,0,1,0,1
ascorbic acid/zinc gluconate,0,0,1,0,0,1
assembled mask,0,0,0,1,0,1
assigned strategies: active choice,0,0,0,1,0,1
assigned strategies: enhanced active choice,0,0,0,1,0,1
assigned strategies: opt-in,0,0,0,1,0,1
at-001,0,0,0,1,0,1
at-527,0,0,0,1,0,1
atazanavir,0,0,0,1,0,1
atazanavir/dexamethasone,0,0,0,1,0,1
ati-450,0,0,0,1,0,1
atovaquone,0,0,0,1,0,1
atovaquone/azithromycin,0,0,0,1,0,1
attention bias modification (abm),0,1,0,0,0,1
attention placebo,0,0,0,1,0,1
atyr1923,0,0,0,1,0,1
auditory evoked potentials (aep),0,0,0,1,0,1
auricular neuromodulation,0,0,0,1,0,1
auricular percutaneous neurostimulation,0,0,0,1,0,1
autologous non-hematopoietic peripheral blood stem cells (nhpbsc),0,1,0,0,0,1
auxora,0,0,0,1,0,1
avdoralimab,0,0,0,1,0,1
avigan,0,0,0,1,0,1
aviptadil,0,0,0,1,0,1
aviptadil/standard care,0,0,0,1,0,1
award,0,0,0,1,0,1
award advice,0,0,0,1,0,1
award/covid-specific advice,0,0,0,1,0,1
azd1222,0,0,0,1,0,1
azd1656,0,0,0,1,0,1
azoximer bromide,0,0,0,1,0,1
bactek-r,0,0,0,1,0,1
bandebereho fathers',0,0,1,0,0,1
bardoxolone methyl,0,0,0,1,0,1
baseline message,0,1,0,0,0,1
basic feedback,0,0,0,1,0,1
bdb-001 injection,0,0,0,1,0,1
behaviour change technique intervention to improve quality of life,0,0,0,1,0,1
bemiparin,0,0,0,1,0,1
berberine,0,1,0,0,0,1
best symptomatic treatment based on doctor recommendations),0,0,0,1,0,1
bgb dxp593,0,0,0,1,0,1
bidirectional oxygenation mouthpiece,0,0,0,1,0,1
bio101,0,0,0,1,0,1
biological test,0,0,0,1,0,1
biological/vaccine: recombinant new coronavirus vaccine (cho cell) low-dose group,0,0,0,1,0,1
biological/vaccine: recombinant new coronavirus vaccine (cho cells) high-dose group,0,0,0,1,0,1
biological/vaccine: recombinant new coronavirus vaccine (cho cells) placebo group,0,0,0,1,0,1
biosensor,0,0,0,1,0,1
biospeciman collection,0,0,0,1,0,1
biospecimen collection,0,0,0,1,0,1
biovitals,0,0,0,1,0,1
bivalirudin,0,0,0,1,0,1
bld-2660,0,0,0,1,0,1
blink,0,0,0,1,0,1
blink/masseter inhibitory reflex,0,0,0,1,0,1
blood collection on their first consultation/10 to 14 days later,0,0,0,1,0,1
blood draw,0,0,0,1,0,1
blood group determination,0,0,0,1,0,1
blood/derivatives,0,0,0,1,0,1
bms-986253,0,0,0,1,0,1
bnt162a1,0,0,0,1,0,1
bnt162b3,0,0,0,1,0,1
bnt162c2,0,0,0,1,0,1
brain mri,0,0,0,1,0,1
brazilian green propolis extract (epp-af),0,1,0,0,0,1
breath test,0,0,0,1,0,1
breath test/cheek swab,0,0,0,1,0,1
"breathing exercise, intensive spirometry use, supported cough, progressive mobilisation",0,0,0,1,0,1
"breathing exercise, intensive spirometry use, supported cough, progressive mobilisation/ambulation",0,0,0,1,0,1
brequinar,0,0,0,1,0,1
bromelain,0,0,0,1,0,1
bromhexine oral tablet and/or hydroxychloroquine tablet,0,0,0,1,0,1
broncho-vaxomâ®,0,0,0,1,0,1
btl-tml-covid,0,0,0,1,0,1
bucillamine,0,0,1,0,0,1
c21,0,0,0,1,0,1
candesartan,0,0,0,1,0,1
care as usual,0,0,1,0,0,1
caring contacts,0,0,0,1,0,1
cash transfer,1,0,0,0,0,1
castem,0,0,0,1,0,1
ccp,0,0,0,1,0,1
cd24fc,1,0,0,0,0,1
cell therapy protocol 1,0,0,0,1,0,1
cell therapy protocol 2,0,0,0,1,0,1
cellulose-containing placebo capsules,0,0,0,1,0,1
centricyte 1000,0,0,1,0,0,1
centrum adult (under 50) multivitamin,0,0,1,0,0,1
cerc-002,0,0,0,1,0,1
certified cloth face mask,0,0,1,0,0,1
certified cloth face mask/preventive information,0,0,1,0,0,1
chat-based instant messaging support,1,0,0,0,0,1
chat-based support,0,0,0,1,0,1
cheek swab,0,0,0,1,0,1
chemokines profiles of patients with dexmedetomidine administration,0,0,0,1,0,1
chest ct,0,1,0,0,0,1
chest ct scan,0,0,0,1,0,1
chest x-ray,0,0,0,1,0,1
chiropractic care (more than one visit),0,1,0,0,0,1
chiropractic care (one visit),0,1,0,0,0,1
chlorhexidine,0,0,0,1,0,1
choice of assignment: active choice,0,0,0,1,0,1
choice of assignment: enhanced active choice,0,0,0,1,0,1
choice of assignment: opt-in,0,0,0,1,0,1
chx0.12,0,0,0,1,0,1
chx0.12/cpc0.05 oral rinse (perioaidactive control),0,0,0,1,0,1
cig axial,1,0,0,0,0,1
cig tilted,1,0,0,0,0,1
citrox,0,0,0,1,0,1
ck0802,0,0,0,1,0,1
clarithromycin,0,0,0,1,0,1
clevudine,0,0,0,1,0,1
clinical examination,0,0,0,1,0,1
clofazimine,0,0,0,1,0,1
cobicistat,0,0,0,1,0,1
cognitive,0,0,0,1,0,1
colchicine pill,0,0,0,1,0,1
colchicine/herbal phenolic monoterpene fractions,0,0,0,1,0,1
colchicine/symptomatic treatment (paracetamol),0,0,0,1,0,1
colgate periogard mouthwash,0,0,1,0,0,1
colgate peroxyl mouthwash,0,0,1,0,0,1
colgate total mouthwash,0,0,1,0,0,1
collagen-polyvinylpyrrolidone,0,0,0,1,0,1
combination,1,0,0,0,0,1
combination of oral polio vaccine/na-831,0,0,1,0,0,1
communication type,0,1,0,0,0,1
community health worker support,0,0,1,0,0,1
community health workers.,0,0,0,1,0,1
community interest message,0,1,0,0,0,1
comparable placebo,0,0,1,0,0,1
comparable placebo of drug,0,0,1,0,0,1
comparable placebo of oral polio vaccine,0,0,1,0,0,1
complement dosage,0,0,0,1,0,1
conestat alfa,0,0,0,1,0,1
conjunctival swab/nasopharyngeal swab,0,0,0,1,0,1
contain covid anxiety ssi,0,0,0,1,0,1
continuation of acei,0,0,0,1,0,1
continuation of acei/arb,0,0,0,1,0,1
continuation of arb,0,0,1,0,0,1
continuation of ras blocker,0,0,0,1,0,1
continuous positive airway pressure,0,0,0,1,0,1
control message,0,1,0,0,0,1
control swab,0,0,0,1,0,1
convalscent plasma,0,0,0,1,0,1
"conventional medicines (oxygen therapy, alfa interferon via aerosol inhalation,",0,0,0,1,0,1
"conventional medicines (oxygen therapy, alfa interferon via aerosol inhalation,/lopinavir/ritonavir)",0,0,0,1,0,1
conventional therapy first,1,0,0,0,0,1
coping strategies video,0,0,0,1,0,1
core warming,0,0,0,1,0,1
cosh self-help smoking cessation booklet,0,0,0,1,0,1
cospherunate,0,0,1,0,0,1
cospherunate/azythromycine,0,0,1,0,0,1
cospherunate/phytomedicine/azythromycien,0,0,1,0,0,1
couples' group education,0,0,1,0,0,1
covi-guard,0,0,0,1,0,1
covid-19 antigen,0,0,0,1,0,1
"covid-19 antigen/antibody rapid testing, mobile device image capture/telemedicine support",0,0,0,1,0,1
covid-19 convalescent plasma (ccp)/standard of care (soc),0,0,0,1,0,1
covid-19 diagnostic test,0,0,0,1,0,1
covid-19 patients,0,0,0,1,0,1
covid-19 related health warning leaflet,0,0,0,1,0,1
covid-19 swab,0,0,0,1,0,1
covid-specific advice,0,0,0,1,0,1
covid19 vaccine,0,0,0,1,0,1
covsurf drug delivery system,0,0,0,1,0,1
cpc0.05 oral rinse (perioaidactive control),0,0,0,1,0,1
cpi-006,0,0,0,1,0,1
crisis intervention therapy,0,0,1,0,0,1
crizanlizumab,0,0,0,1,0,1
csvf,0,0,1,0,0,1
ctus examination,0,0,0,1,0,1
cupping,0,0,0,1,0,1
current care per ucla treating physicians,0,0,0,1,0,1
cvncov vaccine,0,0,0,1,0,1
cyp-001,0,0,0,1,0,1
cytokines,0,0,0,1,0,1
d,0,0,0,1,0,1
d followed by enoxaparin,0,0,0,1,0,1
daily coping toolkit,0,0,0,1,0,1
daily monitoring,0,0,0,1,0,1
daily room disinfection,0,1,0,0,0,1
dalargin,1,0,0,0,0,1
danoprevir,0,1,0,0,0,1
danoprevir/ritonavir,0,1,0,0,0,1
dapansutrile capsules,0,0,0,1,0,1
darunavir,0,0,0,1,0,1
darunavir/cobicistat,0,0,0,1,0,1
das181,0,1,0,0,0,1
data collection/rhinopharyngeal swab,0,1,0,0,0,1
day,0,0,0,1,0,1
decitabine,0,0,0,1,0,1
deferoxamine,0,0,0,1,0,1
defibrotide,0,0,0,1,0,1
defibrotide 25 mg/kg 24 hours continuous infusion for 15 days,0,0,0,1,0,1
degarelix,0,0,0,1,0,1
deglycyrrhizinated licorice,0,0,0,1,0,1
derivatives.,0,0,0,1,0,1
desidustat,0,0,0,1,0,1
device),0,0,0,1,0,1
dexamethasone/hydroxychloroquine,0,0,0,1,0,1
dexcom,0,0,0,1,0,1
dfv890,0,0,0,1,0,1
diagnostic,0,0,0,1,0,1
diagnostic test covid-19,0,0,0,1,0,1
diagnostic test for sars-cov2 for patients,0,0,0,1,0,1
diagnostic test for sars-cov2 for patients/health staff,0,0,0,1,0,1
diagnostic tests for covid-19 infection,0,0,0,1,0,1
dialectical behavioral therapy (dbt) skills,0,0,0,1,0,1
dietary supplement containing resistant starch,0,0,0,1,0,1
difficulties lived by disabled children's parents in the period of covid-19 pandemic,0,0,0,1,0,1
dig axial,1,0,0,0,0,1
dig tilted,1,0,0,0,0,1
digital cardiac counseling,0,0,0,1,0,1
digital health online platform,0,0,0,1,0,1
diovan,0,0,0,1,0,1
direct antigen tests for covid-19,0,1,0,0,0,1
direct laryngoscope,1,0,0,0,0,1
discontinuation of acei,0,0,0,1,0,1
discontinuation of acei/arb,0,0,0,1,0,1
discontinuation of arb,0,0,1,0,0,1
discontinuation of ras blocker,0,0,0,1,0,1
discussion board for social support,0,0,0,1,0,1
discussion board for social support /basic feedback,0,0,0,1,0,1
discussion board for social support/personalized feedback,0,0,0,1,0,1
distance learning,0,0,1,0,0,1
dociparastat sodium,0,0,0,1,0,1
doppler echo,0,0,0,1,0,1
dornase alfa,0,0,0,1,0,1
double-blind nt-i7,0,0,0,1,0,1
drugs,0,0,0,1,0,1
drugs/supportive care,0,0,0,1,0,1
dur-928,0,0,0,1,0,1
dutasteride,0,0,0,1,0,1
ðžxygen therapy,0,0,0,1,0,1
e-psychotherapy,0,0,0,1,0,1
early-dexamethasone,0,0,0,1,0,1
ec-18,0,0,0,1,0,1
ecco2r,0,0,0,1,0,1
economic benefit message,0,1,0,0,0,1
economic freedom message,0,1,0,0,0,1
eculizumab,0,0,0,1,0,1
educational video,0,0,0,1,0,1
eeg,0,0,0,1,0,1
eit-group,0,0,0,1,0,1
eltrombopag,0,0,0,1,0,1
emapalumab,0,0,0,1,0,1
embarrassment message,0,1,0,0,0,1
emotional support plan,0,0,0,1,0,1
emtricitabine/tenofovir,0,0,0,1,0,1
emtricitabine/tenofovir disoproxil,0,0,0,1,0,1
endoscopy,0,1,0,0,0,1
enoxaparin/lovenox,0,0,0,1,0,1
enriched survey feedback,0,0,0,1,0,1
ensifentrine,0,0,0,1,0,1
ent exam,0,0,0,1,0,1
enzalutamide,0,0,0,1,0,1
ep,0,0,0,1,0,1
epic risk score display,0,0,0,1,0,1
epivaccorona (epivaccorona vaccine based on peptide antigens for the prevention of covid-19),1,0,0,0,0,1
escin,0,0,0,1,0,1
essential oils,0,1,0,0,0,1
estradiol,0,0,0,1,0,1
etoposide,0,0,0,1,0,1
exercise booklet,0,0,0,1,0,1
exercise program,0,0,0,1,0,1
exhaled breath sampling,0,0,0,1,0,1
exo 1 inhalation,0,0,1,0,0,1
exo 2 inhalation,0,0,1,0,0,1
experimental group,0,0,0,1,0,1
experimental: questionnaire without precaution information,0,1,0,0,0,1
extracorporeal blood purification using the oxirisâ® (an69st) hemofilter,0,0,0,1,0,1
f-652,0,0,0,1,0,1
family nurture intervention (fni),0,0,0,1,0,1
farmalarm,0,1,0,0,0,1
favipiravir / standard care,1,0,0,0,0,1
favipiravir/azithromycin,0,0,0,1,0,1
favipiravir/chloroquine,0,0,0,1,0,1
favipiravir/nitazoxanide,0,0,0,1,0,1
favipiravir/tocilizumab,0,0,0,1,0,1
feces samples (covi-biome ancillary study),0,0,0,1,0,1
fenofibrate,0,0,1,0,0,1
filmarray pneumonia,0,1,0,0,0,1
filtration test,0,1,0,0,0,1
fingerstick,0,0,0,1,0,1
fingolimod,0,0,0,1,0,1
fisetin,0,0,1,0,0,1
fit test,0,1,0,0,0,1
flow controlled ventilation (evone-ventilator),0,0,0,1,0,1
fluoxetine,0,0,0,1,0,1
fluvoxamine,1,0,0,0,0,1
folic acid,1,0,0,0,0,1
fondapariniux,0,0,0,1,0,1
fondaparinux,0,1,0,0,0,1
formoterol,0,0,0,1,0,1
freestyle libre 14 day cgm system,0,0,0,1,0,1
fuzheng huayu,0,0,0,1,0,1
gam-covid-vac lyo,0,1,0,0,0,1
gamification,0,0,0,0,1,1
gammacoreâ® (vagus nerve stimulation),0,0,0,1,0,1
gammacoreâ® sapphire (non-invasive vagus nerve stimulator),0,0,0,1,0,1
gamunex-c,0,0,0,1,0,1
ganovo,0,1,0,0,0,1
ganovo/ritonavir//-interferon nebulization,0,1,0,0,0,1
"garadacimab, factor xiia antagonist monoclonal antibody",0,0,0,1,0,1
gargle,0,0,0,1,0,1
gas exchanges at different peep,0,1,0,0,0,1
gc4419,0,0,0,1,0,1
gc5131,0,0,0,1,0,1
general health education,0,0,0,1,0,1
gimsilumab,0,0,0,1,0,1
gls-1200,0,0,0,1,0,1
glycine,0,0,0,1,0,1
go2 peep mouthpiece,0,0,0,1,0,1
grad-cov2,0,0,0,1,0,1
group 1: rivaroxaban 20mg/d followed by enoxaparin/unfractionated heparin when needed,0,0,0,1,0,1
guduchi ghan vati,0,1,0,0,0,1
guided online support program,0,0,0,1,0,1
guilt message,0,1,0,0,0,1
gx-19,0,0,0,1,0,1
hads,0,0,0,1,0,1
health enhancement program,0,0,0,1,0,1
health literacy,0,0,0,1,0,1
health staff,0,0,0,1,0,1
health warning leaflet,0,0,0,1,0,1
healthy lifestyle advise,0,0,0,1,0,1
healthy minds program foundations training,0,0,0,1,0,1
hemodynamics changes at different peep,0,1,0,0,0,1
herbal phenolic monoterpene,0,0,0,1,0,1
high-titer convalescent covid-19 plasma (ccp1),0,0,0,1,0,1
high dose radiation 100 cgy,0,0,0,1,0,1
high flow nasal cannula (hfnc),0,0,0,1,0,1
high flow nasal cannula hfnc,0,0,0,1,0,1
high intensity interval training group,1,0,0,0,0,1
home-cov rule implementation,0,1,0,0,0,1
home care monitoring,0,0,0,0,1,1
home pulse oximetry monitoring,0,1,0,0,0,1
hope intervention,1,0,0,0,0,1
human amniotic fluid,0,0,0,1,0,1
human cord tissue mesenchymal stromal cells,0,0,0,1,0,1
hydrocortisone,1,0,0,0,0,1
hydrogen oxygen generator with nebulizer,0,1,0,0,0,1
hydroxychloroquine / oxygen,0,1,0,0,0,1
hydroxychloroquine/azithromycin/ tocilizumab,1,0,0,0,0,1
hydroxychloroquine/clindamycin,0,1,0,0,0,1
hydroxychloroquine/clindamycin/primaquine,0,1,0,0,0,1
hydroxychloroquine/doxycycline,0,1,0,0,0,1
hydroxychloroquine/lopinavir/ritonavir,0,0,0,1,0,1
hydroxychloroquine/placebo,0,0,0,0,1,1
hydroxyvitamin,0,0,0,1,0,1
hypothermia via cooling machine- arctic sun 5000,0,0,0,1,0,1
icatibant,0,0,0,1,0,1
icosapent ethyl,0,0,0,1,0,1
icu recovery,0,0,0,1,0,1
icu recovery / physical therapy,0,0,0,1,0,1
ifx-1,0,0,0,1,0,1
igg/igm rapid test,0,0,0,1,0,1
igiv,0,0,0,1,0,1
igm/igg rapid test,0,0,0,1,0,1
imm-101,0,0,0,1,0,1
immunofree tablets,0,0,0,1,0,1
immunofree tablets/reginmune capsule,0,0,0,1,0,1
inactivated vaccine,0,0,0,1,0,1
indian costus,0,0,0,1,0,1
indomethacin,0,0,0,1,0,1
inflammatory cytokines,0,0,0,1,0,1
inflammatory cytokines/chemokines profiles of patients with dexmedetomidine administration,0,0,0,1,0,1
infliximab,0,0,0,1,0,1
injection,0,0,0,1,0,1
inm005,0,0,0,1,0,1
inopulse,0,0,0,1,0,1
insulin,0,0,0,1,0,1
interferon-î² 1a,0,0,1,0,0,1
intermediate dose enoxaparin/ unfractionated heparin,0,0,0,1,0,1
intermittent,1,0,0,0,0,1
internet-based cognitive behavioral therapy,0,0,1,0,0,1
internet-based self-help,0,0,0,1,0,1
internet-based self-help after 3 weeks,0,0,0,1,0,1
internet-delivered cognitive behavior therapy (icbt) for dysfunctional worry related to the covid-19 pandemic,1,0,0,0,0,1
intervention app,0,1,0,0,0,1
intervention group coronacope,0,0,0,1,0,1
intervention group_rehabilitation program,0,0,0,1,0,1
intervention program,0,0,0,1,0,1
interview by psychologists,0,0,0,1,0,1
intramuscular vaccine,1,0,0,0,0,1
intraosseous,0,1,0,0,0,1
intravenous,0,1,0,0,0,1
intravenous drug,0,0,0,1,0,1
invasive mechanical ventilation using the unisabana-herons ventilator during 24 hours,0,1,0,0,0,1
iota-carrageenan,0,0,0,1,0,1
isoflurane inhalant product,0,0,0,1,0,1
itolizumab,0,1,0,0,0,1
ivermectin (iver pâ®) arm will receive ivm 600 âµg,0,1,0,0,0,1
ivermectin (iver pâ®) arm will receive ivm 600 âµg / kg once daily/standard care. control arm will receive standard care.,0,1,0,0,0,1
ivermectin / chloroquine,0,0,0,1,0,1
ivermectin / doxycycline / placebo,0,0,1,0,0,1
ivermectin / placebo,0,0,1,0,0,1
ivermectin/doxycycline,0,1,0,0,0,1
ivig,0,0,0,1,0,1
kamada anti-sars-cov-2,0,0,0,1,0,1
kelea water,0,0,0,1,0,1
ketamine,0,0,0,1,0,1
ketogenic diet,0,0,0,1,0,1
kg 24 hours continuous infusion for 15 days,0,0,0,1,0,1
kg once daily,0,1,0,0,0,1
kundalini yoga,0,0,0,1,0,1
kundalini yoga/anxiety reduction training,0,0,0,1,0,1
lactobaciltus rhamnosus gg,0,0,0,1,0,1
lambda 180 mcg s.c,0,0,0,1,0,1
laryngoscopy,0,0,0,1,0,1
lau-7b,0,0,0,1,0,1
leaf-4l6715,0,0,0,1,0,1
leaf-4l7520,0,0,0,1,0,1
leflunomide,0,0,0,1,0,1
let it out (lio)-c,1,0,0,0,0,1
leukapheresis,0,0,0,1,0,1
levamisole,0,0,0,1,0,1
levamisole / budesonide/formoterol,0,0,0,1,0,1
levilimab,1,0,0,0,0,1
liberase enzyme,0,0,1,0,0,1
licorice extract,0,0,0,1,0,1
lifestyle change promotion program,0,0,0,1,0,1
limbix spark,0,0,0,1,0,1
linagliptin,0,0,0,1,0,1
linagliptin 5 mg,0,0,0,1,0,1
liposomal,0,1,0,0,0,1
longitudinally,0,0,0,1,0,1
lopinavir/ ritonavir,0,0,0,1,0,1
lopinavir/ ritonavir placebo,0,0,0,1,0,1
lopinavir/ritonavir / hydoxychloroquine,0,0,0,1,0,1
losmapimod,0,0,0,1,0,1
lovenox,0,0,0,1,0,1
low dose radiation 35 cgy,0,0,0,1,0,1
low/upper respiratory tract sample,0,0,0,1,0,1
lung impedance,0,0,0,1,0,1
lung mechanics at different peep,0,1,0,0,0,1
lung ultrasound use in patients hospitalized with covid,0,0,0,1,0,1
lv-smenp-dc vaccine,0,0,0,1,0,1
lv-smenp-dc vaccine/antigen-specific ctls,0,0,0,1,0,1
ly3127804,1,0,0,0,0,1
ly3832479,0,0,0,1,0,1
m-m-r ii â® vaccine,0,0,0,1,0,1
m5049,0,0,0,1,0,1
magnetic resonance spectroscopy (mrs).,0,0,0,1,0,1
maintenance,0,0,0,1,0,1
makair,0,0,0,1,0,1
manremyc,0,0,0,1,0,1
marker therapeutics d2000 cartridge (d2000) for use with the spectra optiaâ® apheresis system (optia spd protocol),0,0,0,1,0,1
mas825,0,0,0,1,0,1
mask,0,1,0,0,0,1
masseter inhibitory reflex,0,0,0,1,0,1
maximal effort test,0,0,0,1,0,1
mcgrath videolaryngoscope,1,0,0,0,0,1
measles-mumps-rubella vaccine,0,0,0,1,0,1
media intervention,0,0,0,1,0,1
medical record review - inpatient treatment,0,0,0,1,0,1
meditation therapy,0,0,0,1,0,1
meditation/anxiety reduction training,0,0,0,1,0,1
medium dosage inactivated sars-cov-2 vaccine on a 0-/14-day schedule,0,0,0,1,0,1
mefloquine/azithromycin/ tocilizumab,1,0,0,0,0,1
melatonin intravenous,0,0,0,1,0,1
melphalan,0,0,0,1,0,1
menacwy,1,0,0,0,0,1
menacwy vaccine,0,0,0,1,0,1
mencare,0,0,1,0,0,1
mencare//bandebereho fathers'/couples' group education,0,0,1,0,0,1
mental well-being,0,0,1,0,0,1
meplazumab,0,0,0,1,0,1
merimepodib,0,0,0,1,0,1
mesenchymal stem cell,0,0,0,1,0,1
mesenchymal stromal cell-based therapy,0,0,0,1,0,1
messaging,0,1,0,0,0,1
metabolic cofactors supplementation,0,0,0,1,0,1
metabolic cofactors supplementation/hydroxychloroquine,0,0,0,1,0,1
metenkefalin,1,0,0,0,0,1
metenkefalin / tridecactide,1,0,0,0,0,1
methylene blue,0,0,0,1,0,1
methylene blue/ vitamin c/n-acetyl cysteine,0,0,0,1,0,1
methylprednisolone injectable product,0,0,0,1,0,1
mf59 adjuvanted sars-cov-2 sclamp vaccine,0,0,0,1,0,1
mindfullness training,0,1,0,0,0,1
mindfulness based intervention,0,1,0,0,0,1
mindfulness session(s),0,0,0,1,0,1
minimal attention control intervention,0,0,0,1,0,1
miniprobe alveoflex,0,0,0,1,0,1
ml intravenous solution [actemra]_#1,0,0,0,1,0,1
ml intravenous solution [actemra]_#1 (2 doses),0,0,0,1,0,1
ml prefilled syringe [kineret],0,0,0,1,0,1
mls laser,0,1,0,0,0,1
molgramostim nebuliser solution,0,0,0,1,0,1
mometasone furoate nasal spray,0,1,0,0,0,1
monitoring visit,0,0,0,1,0,1
monoclonal antibody,0,0,0,1,0,1
montmorrillonite,0,1,0,0,0,1
mouthrinse with bãªta-cyclodextrin,0,0,0,1,0,1
mouthrinse with bãªta-cyclodextrin/citrox,0,0,0,1,0,1
mouthrinse without bãªta-cyclodextrin,0,0,0,1,0,1
mouthrinse without bãªta-cyclodextrin/citrox,0,0,0,1,0,1
moxibustion,0,0,0,1,0,1
moxibustion/cupping,0,0,0,1,0,1
mr,0,0,0,1,0,1
mr/m-m-r ii â® vaccine,0,0,0,1,0,1
mrx-4dp0004,0,0,0,1,0,1
mstt1041a,0,0,0,1,0,1
mucodentol,0,0,0,1,0,1
multicomponent treatment virtual fibrowalk,0,0,0,1,0,1
multistem,0,0,0,1,0,1
n-acetyl cysteine,1,0,0,0,0,1
na-831/atazanavir,0,0,0,1,0,1
na-831/dexamethasone,0,0,0,1,0,1
nacl solution,0,0,0,1,0,1
naltrexone,0,0,0,1,0,1
nasal,0,0,0,1,0,1
nasal lavage,0,0,1,0,0,1
nasopharyngeal swabs,0,0,0,1,0,1
nasovax,0,0,0,1,0,1
negative covid test result - hypothetical scenario,0,1,0,0,0,1
neuromuscular,0,0,0,1,0,1
neuromuscular electrical stimulation,0,0,0,1,0,1
neutral writing control,1,0,0,0,0,1
newsfeed function,0,0,0,0,1,1
ng biotech,0,0,0,1,0,1
ng test,0,0,0,1,0,1
niclosamide suspension,0,0,0,1,0,1
nicotinamide riboside,0,0,0,1,0,1
nigella sativa oil,0,0,0,1,0,1
nioâ® (intraosseous access),1,0,0,0,0,1
nitazoxanide / ivermectin,0,0,0,1,0,1
nitric oxide delivered via lungfitâ„¢ system,0,0,0,1,0,1
nk-1r antagonist,0,0,0,1,0,1
no instruction regarding positioning,0,0,0,1,0,1
non-contact mce system,0,1,0,0,0,1
non-invasive red lllt treatment to chest of patient.,0,0,0,1,0,1
non-mindfulness intervention,0,0,0,1,0,1
"normal saline solution (nss), placebo - phase 1",0,0,0,1,0,1
"normal saline solution (nss), placebo - phase 2",0,0,0,1,0,1
"normal saline solution (nss), placebo, day 189 - phase 2",0,0,0,1,0,1
"normal saline solution (nss), placebo, day 21 - phase 1",0,0,0,1,0,1
"normal saline solution (nss), placebo, day 21 - phase 2",0,0,0,1,0,1
not bravery message,0,1,0,0,0,1
np-120 (ifenprodil),0,0,0,1,0,1
nudge,0,0,0,0,1,1
nusepinâ® 0.1 mg,0,0,0,1,0,1
nusepinâ® 0.2 mg,0,0,0,1,0,1
nutrition,0,0,0,1,0,1
nuvastatic,0,0,0,1,0,1
observation,0,0,0,1,0,1
obvio-19 app,0,0,0,1,0,1
olfactometry,0,0,0,1,0,1
olokizumab,0,1,0,0,0,1
omega 3/nigella sativa oil,0,0,0,1,0,1
omega 3/nigella sativa oil/anise seed capsule,0,0,0,1,0,1
omega 3/nigella sativa oil/deglycyrrhizinated licorice,0,0,0,1,0,1
omega 3/nigella sativa oil/indian costus,0,0,0,1,0,1
omega 3/nigella sativa oil/quinine pills,0,0,0,1,0,1
omeprazole,0,0,0,1,0,1
one covid-19 vaccine candidate (tmv-083) administration - high dose,0,0,0,1,0,1
online intervention mental health covid-19,0,0,0,1,0,1
online questionnaires,0,0,0,1,0,1
op-101,0,0,0,1,0,1
ophtamesone,0,0,0,1,0,1
opt-in recruitment email,0,0,1,0,0,1
opt-out recruitment email,0,0,1,0,0,1
optical coherence tomography (oct),0,0,0,1,0,1
"or psychotherapy, n=10)",1,0,0,0,0,1
oral,0,0,0,1,0,1
oral polio vaccine / information,0,0,1,0,0,1
oseltamivir 75mg,0,0,0,1,0,1
osoc,0,0,0,1,0,1
otilimab,0,0,0,1,0,1
oxygen-ozone,0,0,0,1,0,1
oxyhydrogen,0,0,0,1,0,1
ozanimod,0,0,0,1,0,1
ozone,0,0,0,1,0,1
p2et (caesalpinia spinosa extract),0,0,0,1,0,1
pacritinib,0,0,0,1,0,1
pamrevlumab,0,0,0,1,0,1
paracetamol,1,0,0,0,0,1
part 1 - tl-895,0,0,0,1,0,1
part 2 - tl-895,0,0,0,1,0,1
passive microwave radiometry,0,1,0,0,0,1
patient-centred advice on telephone consultation in tb patients:,0,0,0,1,0,1
pb1046,0,0,0,1,0,1
pbmt,0,0,0,1,0,1
pbmt/smf,0,0,0,1,0,1
pcr/serology,0,0,0,1,0,1
peer resilience champion,0,0,0,1,0,1
pegylated interferon-î±2b,0,0,0,1,0,1
pembrolizumab,0,0,0,1,0,1
pentoxifylline,1,0,0,0,0,1
performance evaluation,0,0,0,1,0,1
performing of lung ultrasound,0,0,0,1,0,1
personal freedom message,0,1,0,0,0,1
personal protective equipment,0,0,0,1,0,1
personalized feedback,0,0,0,1,0,1
personalized health education,0,0,0,1,0,1
phase 1,0,0,0,1,0,1
phase 2,0,0,0,1,0,1
phr160 spray,0,0,0,1,0,1
physiotherapy,0,0,0,1,0,1
physiotherapy part of virtual fibrowalk,0,0,0,1,0,1
phytomedicine,0,0,1,0,0,1
pioglitazone,0,0,0,1,0,1
piperacillin,0,0,0,1,0,1
piperacillin/tazobactam,0,0,0,1,0,1
pirfenidone,0,0,0,1,0,1
placebo (0.9% normal saline),0,0,0,1,0,1
placebo (pb0),0,0,0,1,0,1
"placebo (sodium chloride bufus, solvent for the preparation of dosage forms for injection 0.9%)",1,0,0,0,0,1
placebo comparator: dw-ni,0,0,0,1,0,1
placebo comparator: dw-ns,0,0,0,1,0,1
placebo intravenous,0,0,0,1,0,1
placebo mouthwash (water),0,0,1,0,0,1
placebo nebuliser solution,0,0,0,1,0,1
placebo of drug,0,0,1,0,0,1
placebo pmdi,0,0,0,1,0,1
placebo rinse,0,0,0,1,0,1
placebo subcutaneous solution,0,0,0,1,0,1
placebo to match rdv,0,0,0,1,0,1
placebo/aluminum adjuvant of inactivated sars-cov-2 vaccine,0,0,0,1,0,1
placebo/control,0,0,0,1,0,1
placenta-derived mmscs; cryopreserved placenta-derived multipotent mesenchymal stromal cells,0,0,0,1,0,1
plant polyphenol,0,0,0,1,0,1
plitidepsin,0,0,0,1,0,1
plx-pad,0,0,0,1,0,1
polio vaccine,0,0,1,0,0,1
poractant alfa,0,0,0,1,0,1
position,0,0,0,1,0,1
positive covid test result - hypothetical scenario,0,1,0,0,0,1
positive feedback,0,1,0,0,0,1
postural positioning,0,0,0,1,0,1
povidone,0,0,0,1,0,1
prayer,0,0,0,1,0,1
prazosin,0,0,0,1,0,1
prediction market,0,1,0,0,0,1
preservision areds formulation gel tabs,0,0,1,0,0,1
primary care,0,1,0,0,0,1
primepro,0,1,0,0,0,1
probiorinse,0,0,0,1,0,1
probiotics,0,0,0,1,0,1
problem-solving,0,0,0,1,0,1
problem-solving/relationship improvement intervention.,0,0,0,1,0,1
procalcitonin,0,0,0,1,0,1
progesterone,1,0,0,0,0,1
progressive cycling exercise test to exhaustion,0,0,0,1,0,1
prolastin,0,0,0,1,0,1
prolectin-m; a (1-6)-alpha-d-mannopyranose class,0,0,0,1,0,1
prophylactic,0,0,0,1,0,1
prophylaxis,0,1,0,0,0,1
propofol,0,0,0,1,0,1
prototype,0,0,0,1,0,1
proxalutamide,0,0,0,1,0,1
psg,0,0,0,1,0,1
psychoeducation,0,0,0,1,0,1
psychoeducational intervention,0,0,0,1,0,1
psychological,0,0,0,1,0,1
psychological/behaviour change support,0,0,0,1,0,1
ptc299,0,0,0,1,0,1
pulmonary anomalies 4 months after documented covid-19 pneumonia,0,0,0,1,0,1
pulmonary function testing,0,0,0,1,0,1
pulmonary physiotherapy techniques,0,1,0,0,0,1
pulmozyme/ recombinant human deoxyribonuclease (rh-dnase),0,0,0,1,0,1
pulse oximetry,0,0,0,1,0,1
pyridostigmine bromide,0,0,0,1,0,1
qazcovid-inâ® - covid-19 inactivated vaccine,0,0,1,0,0,1
quadramune(tm),0,0,0,1,0,1
quality-of-life assessment,0,0,0,1,0,1
quality of life promotion,0,0,1,0,0,1
quinine,0,0,0,1,0,1
quinquina-stevia,0,0,1,0,0,1
quinquina-stevia/azythromycin,0,0,1,0,0,1
r tablets,1,0,0,0,0,1
radiological,0,0,0,1,0,1
ramipril,0,0,1,0,0,1
rapid salivary test,0,0,0,1,0,1
rapid serological test,0,0,0,1,0,1
razuprotafib,0,0,0,1,0,1
razuprotafib subcutaneous solution,0,0,0,1,0,1
rbt-9 (90 mg),0,0,0,1,0,1
rdv,0,0,0,1,0,1
reading a book,0,0,0,1,0,1
recharge,0,0,0,1,0,1
recombinant human interferon î±2b spray,1,0,0,0,0,1
recombinant human plasma gelsolin (rhu-pgsn),0,0,0,1,0,1
rectal swab,0,0,0,1,0,1
referral card,0,0,0,1,0,1
reginmune,0,0,0,1,0,1
regular care,0,0,0,1,0,1
rehabilitation,0,1,0,0,0,1
relationship improvement intervention.,0,0,0,1,0,1
remain covid free ssi,0,0,0,1,0,1
remestemcel-l,0,0,0,1,0,1
remote cognitive behavioral therapy for insomnia,0,0,0,1,0,1
removal of dead space filter,0,0,0,1,0,1
renin-angiotensin system inhibitors,0,0,0,1,0,1
"resp301, a nitric oxide generating solution",0,0,0,1,0,1
respiratory function rehabilitation training,0,0,0,1,0,1
respiratory tract sample,0,0,0,1,0,1
rh-dnase,0,0,0,1,0,1
rhace2,0,0,0,1,0,1
rhinopharyngeal,0,1,0,0,0,1
rhtpo,0,0,0,1,0,1
rintatolimod,0,0,0,1,0,1
ritonavir placebo,0,0,0,1,0,1
ritonavir/oseltamivir,0,0,0,1,0,1
roactemra,0,0,0,1,0,1
robot assisted percutaneous cardiovascular intervention,0,0,0,1,0,1
rosuvastatin,0,0,0,1,0,1
rph-104,0,1,0,0,0,1
rtb101,0,0,0,1,0,1
sab-185,0,0,0,1,0,1
saline-sodium citrate (ssc) buffer,0,0,0,1,0,1
saline containing 1% human serum albuminï¼ˆsolution without uc-mscsï¼‰,0,1,0,0,0,1
saline with baby shampoo nasal irrigation,0,0,0,1,0,1
saline/standard care,0,0,0,1,0,1
sample collection,0,0,0,1,0,1
sample collection/performance evaluation (a),0,0,0,1,0,1
sample collection/performance evaluation (b),0,0,0,1,0,1
sampling,0,0,0,1,0,1
sar443122,0,0,0,1,0,1
sars-cov-2 antibody based ivig therapy,0,0,0,1,0,1
sars-cov-2 infection,1,0,0,0,0,1
"sars-cov-2 research in nasopharyngeal swab, sperm",0,0,0,1,0,1
"sars-cov-2 research in nasopharyngeal swab, sperm/serologics",0,0,0,1,0,1
sars-cov-2 specific t cells,0,0,0,1,0,1
sars-cov-2 vaccine formulation 1 with adjuvant 1,0,0,0,1,0,1
sars-cov-2 vaccine formulation 1 with adjuvant 2,0,0,0,1,0,1
sars-cov-2 vaccine formulation 2 with adjuvant 1,0,0,0,1,0,1
sars-cov-2 vaccine formulation 2 with adjuvant 2,0,0,0,1,0,1
sars-cov-2 vaccine formulation 2 without adjuvant,0,0,0,1,0,1
scb-2019,0,0,0,1,0,1
scb-2019 with as03 adjuvant,0,0,0,1,0,1
scb-2019 with cpg 1018 adjuvant,0,0,0,1,0,1
scb-2019 with cpg 1018 adjuvant/alum adjuvant,0,0,0,1,0,1
scd,0,0,0,1,0,1
sch intervention,0,0,1,0,0,1
self-compassion for chronic pain virtual group treatment program,0,0,0,1,0,1
self-help booklet,1,0,0,0,0,1
self-interest message,0,1,0,0,0,1
self-management booklet (switch: stay well during covid-19),1,0,0,0,0,1
self-questionnary,0,0,0,1,0,1
self study,0,0,0,1,0,1
selinexor,0,0,0,1,0,1
serum,0,0,0,1,0,1
sessions,1,0,0,0,0,1
shared decision making,0,0,1,0,0,1
shg,0,0,0,1,0,1
sildenafil,0,0,0,1,0,1
sildenafil citrate,0,0,0,1,0,1
silymarin,0,0,0,1,0,1
simha kriya,0,0,0,1,0,1
simple cognitive task intervention,0,0,0,1,0,1
simvastatin,0,0,0,1,0,1
sirukumab,0,0,0,1,0,1
sivomixx,0,0,0,1,0,1
sledd with a l-mod,0,0,0,1,0,1
smf,0,0,0,1,0,1
sms-based support,0,0,0,1,0,1
sms message support,1,0,0,0,0,1
sng001,0,0,0,1,0,1
soc / ifx-1,0,0,0,1,0,1
soc / intravenous famotidine,0,0,0,1,0,1
sodium bicarbonate,1,0,0,0,0,1
sofosbuvir/daclatasvir,0,0,0,1,0,1
sorbitol,0,0,0,1,0,1
spartan covid-19 system,0,0,0,1,0,1
specific exercise rehabilitation treatment,0,0,0,1,0,1
spin-chat program,0,1,0,0,0,1
staff wellbeing centres,0,0,0,1,0,1
standard-titer convalescent covid-19 plasma (ccp2),0,0,0,1,0,1
standard interface,0,1,0,0,0,1
standard of care (paracetamol),0,0,0,1,0,1
standard of care (soc)/placebo,0,0,0,1,0,1
standard of care thromboprophylaxis,0,0,0,1,0,1
standard prophylactic dose enoxaparin,0,0,0,1,0,1
standard prophylactic dose enoxaparin/ unfractionated heparin,0,0,0,1,0,1
standard treatment for covid-19,0,0,0,1,0,1
stellate ganglion block,0,0,0,1,0,1
stimulation test with arginine infusion in order to verify the possible existence of damage to the beta cell function induced by covid-19 infection,0,0,0,1,0,1
sudarshan kriya yoga (sky),0,0,0,1,0,1
sulfamethoxazole,0,0,0,1,0,1
sulodexide,0,1,0,0,0,1
supine positioning,0,0,0,1,0,1
supportive/symptomatic treatment,1,0,0,0,0,1
surgical facial mask,0,1,0,0,0,1
suspension,0,0,0,1,0,1
suspension of heat killed (autoclaved) mycobacterium w,0,0,0,1,0,1
suspension/maintenance of angiotensin receptor blockers/angiotensin-converting enzyme inhibitors,0,0,0,1,0,1
swab,0,0,0,1,0,1
sweat samples (covidog ancillary study),0,0,0,1,0,1
symbicort,0,0,0,1,0,1
symptomatic treatment,1,0,0,0,0,1
symptomatic treatment (paracetamol,0,0,0,1,0,1
symptomatic treatment (paracetamol),0,0,0,1,0,1
symptomatic treatment (paracetamol/best symptomatic treatment based on doctor recommendations),0,0,0,1,0,1
synthetic neutralising antibodies,0,0,0,1,0,1
t cell derived exosom,1,0,0,0,0,1
t3 solution,0,0,0,1,0,1
tacrolimus,0,0,0,1,0,1
tape-software,0,0,0,1,0,1
tau,0,0,0,1,0,1
tau / multicomponent treatment virtual fibrowalk,0,0,0,1,0,1
tau / physiotherapy part of virtual fibrowalk,0,0,0,1,0,1
tazobactam,0,0,0,1,0,1
tcc-covid mhealth,0,0,0,1,0,1
td139,0,0,0,1,0,1
tele-interventions related to diabetes management,0,0,1,0,0,1
tele-interventions related to diabetes management/mental well-being,0,0,1,0,0,1
telephone follow-up,0,0,0,1,0,1
telesimulation,0,0,0,1,0,1
tenecteplase,0,0,0,1,0,1
tenofovir,0,0,0,1,0,1
tenofovir disoproxil,0,0,0,1,0,1
tetrandrine,0,0,1,0,0,1
the management of severe covid-19 cases,0,0,0,1,0,1
therapeutic exercise,0,0,1,0,0,1
therapeutic exercise/education,0,0,1,0,0,1
theraputic heparin,0,0,0,1,0,1
therapy intervention,0,0,0,1,0,1
throat swab,0,0,0,1,0,1
thymalfasin,0,0,0,1,0,1
thymosin,0,0,0,1,0,1
tigeraseâ®,0,0,0,1,0,1
tigeraseâ®/best available care,0,0,0,1,0,1
tirofiban,0,1,0,0,0,1
tj003234,0,0,0,1,0,1
tnkase,1,0,0,0,0,1
tociliuzumab,0,1,0,0,0,1
tocilizumab 20 mg/ml intravenous solution [actemra]_#1,0,0,0,1,0,1
tocilizumab 20 mg/ml intravenous solution [actemra]_#1 (2 doses),0,0,0,1,0,1
tracheotomy,0,0,0,1,0,1
tradipitant,0,0,1,0,0,1
traditional chinese medicine,0,0,0,1,0,1
training clinicians in basic critical care,0,0,0,1,0,1
training clinicians in basic critical care/the management of severe covid-19 cases,0,0,0,1,0,1
"training for awareness, resilience,",0,1,0,0,0,1
"training for awareness, resilience,/action (tara)",0,1,0,0,0,1
"training of youth, community health assistants",0,0,0,1,0,1
"training of youth, community health assistants/community health workers.",0,0,0,1,0,1
training session adressing information,0,0,0,1,0,1
training session adressing information/health literacy,0,0,0,1,0,1
tranexamic acid,0,0,0,1,0,1
trans sodium crocetinate,0,0,0,1,0,1
transcutaneous auricular vagus nerve stimulation,0,0,0,1,0,1
transpulmonary pressure measurements,0,0,0,1,0,1
trauma-informed yoga video recording,0,0,0,1,0,1
treamid,0,0,0,1,0,1
treatment,0,1,0,0,0,1
treatment as usual (tau),0,0,0,1,0,1
treatment/prophylaxis,0,1,0,0,0,1
tridecactide,1,0,0,0,0,1
trimethoprim,0,0,0,1,0,1
trimethoprim/sulfamethoxazole,0,0,0,1,0,1
trimoxazole,0,0,0,1,0,1
trust in science message,0,1,0,0,0,1
tsvf,0,0,1,0,0,1
two covid-19 vaccine candidate (tmv-083) administrations - high dose,0,0,0,1,0,1
two covid-19 vaccine candidate (tmv-083) administrations - low dose,0,0,0,1,0,1
"two doses of high dosage inactivated sars-cov-2 vaccine at the schedule of day 0,28",1,0,0,0,0,1
"two doses of low dosage inactivated sars-cov-2 vaccine at the schedule of day 0,28",1,0,0,0,0,1
"two doses of medium dosage inactivated sars-cov-2 vaccine at the schedule of day 0,28",1,0,0,0,0,1
txa127,0,0,0,1,0,1
ultra brief online mindfulness-based intervention,0,1,0,0,0,1
umbilical cord mesenchymal stem cells / heparin along with best supportive care.,1,0,0,0,0,1
umifenovir,0,0,1,0,0,1
unavailable covid test result - hypothetical scenario,0,1,0,0,0,1
unfractionated heparin iv,0,0,0,1,0,1
unfractionated heparin sc,0,0,0,1,0,1
unified protocol for covid-19 parenting stress (up-covid),0,0,0,1,0,1
unsupervised physical activities,0,0,0,1,0,1
usual antibiotic treatment,0,0,0,1,0,1
usual care positioning with no instructions,1,0,0,0,0,1
usual practice / symbicort rapihaler,0,0,0,1,0,1
utooth btc),0,0,0,1,0,1
uttr1147a,0,0,0,1,0,1
uv light treatment,0,0,0,1,0,1
v-sars,1,0,0,0,0,1
v591,0,0,0,1,0,1
vaccine: recombinant new coronavirus vaccine (cho cell) low-dose group,0,0,0,1,0,1
vaccine: recombinant new coronavirus vaccine (cho cells) high-dose group,0,0,0,1,0,1
vaccine: recombinant new coronavirus vaccine (cho cells) placebo group,0,0,0,1,0,1
vadadustat,0,0,0,1,0,1
vehicle,1,0,0,0,0,1
vehicle / heparin along with best supportive care,1,0,0,0,0,1
vehicle control,0,0,0,1,0,1
verapamil,0,0,0,1,0,1
veru-111,0,0,0,1,0,1
vib7734,0,0,0,1,0,1
vibrolung,0,0,0,1,0,1
video chat,0,0,0,1,0,1
video chat / basic feedback,0,0,0,1,0,1
video chat /personalized feedback,0,0,0,1,0,1
video dance classes,0,0,0,1,0,1
vielight rx plus,0,0,0,1,0,1
vir-7831,0,0,0,1,0,1
virtual care at home,0,0,0,1,0,1
virtual group intervention,0,0,0,1,0,1
virtual reality,0,0,0,1,0,1
virtual reality therapy first,1,0,0,0,0,1
viruxal oral,0,0,0,1,0,1
viruxal oral/nasal spray,0,0,0,1,0,1
vitamin b,0,0,0,1,0,1
vitamin c tablets,0,0,0,1,0,1
vitamin e,1,0,0,0,0,1
vitamins,0,0,0,1,0,1
viusid,0,0,0,1,0,1
viusid/asbrip,0,0,0,1,0,1
volatile organic compounds analysis,0,0,0,1,0,1
vv-ecmo,0,0,0,1,0,1
vv-ecmo / cytokine adsorption,0,0,0,1,0,1
vxa-cov2-1,0,0,0,1,0,1
water without an elevated level of kelea,0,0,0,1,0,1
wearing surgical face mask sprayed with hypertonic saline,0,0,0,1,0,1
weekly assessment,0,0,0,1,0,1
who recommendations (waiting condition),0,0,0,1,0,1
withings scanwatch,0,0,0,1,0,1
woebot substance use disorder,0,0,0,1,0,1
xav-19,0,0,0,1,0,1
xc221,0,0,0,1,0,1
xcel-umc-beta,0,0,0,1,0,1
yoga group,1,0,0,0,0,1
zanubrutinib,0,0,0,1,0,1
zavegepant (bhv-3500),0,0,0,1,0,1
zidovudine,0,1,0,0,0,1
zilucoplanâ®,0,0,0,1,0,1
zinc citrate,0,0,0,1,0,1
zithromax,0,0,0,1,0,1
zofin,0,0,0,1,0,1
